*************************
          *         *     *
* ***** * * *** * *** * * *
* *     * * *   * * * * * *
* * *** *** ******* * *****
* * *     *     * * * *   *
* *** *** * ***** * * * ***
*   * *   * *   *       * *
* *** * *** *** ***** *** *
*   * *   *           * * *
*** * * *** *********** * *
* * * * *     *     *     *
* ***** * * * ***** * *** *
* * *   * * *   * * * *   *
* * * *** ******* * ***** *
* *     *   * * *     *   *
* * *** * *** * ***** * ***
*     * * *     *         *
*** * * * ***** * * * *****
*   * * * * *   * * *     *
* * ***** * * * * ******* *
* * *     * * *   * *   * *
* *** * *** * * *** *** * *
*   * *   * * * * *   * * *
* *** * *** * * * * *** * *
*     *       *         * 
************************* 

