 ***************************
  *   *   *   *         * * *
* *** * *** * * * *** * * * *
* *   * *   *   *   * *     *
* * *** ******* *********** *
*   *     *     * * *     * *
* * * ********* * * * *** * *
* *   * * *   *     *   *   *
* *** * * * *** *** * *** * *
* *   *       * *   * *   * *
*** *** *** * * ***** *******
*     * *   *     *   * *   *
* * *** ***** ******* * * ***
* *   *     *     *   *     *
* *** * ********* *** * * * *
* * * *   *   *     *   * * *
* * *** * * ***** ***** *****
*       *       *   *   * * *
* *** * *************** * * *
*   * *   *     *       *   *
* *** *** ***** ***** *** ***
*   * * * *     *     *   * *
* ***** * ***** * ***** * * *
* *       * *   *   *   *   *
***** *** * *** * * ******* *
*   * *     *   * *     *   *
*** * *** * *** ***** * *** *
*       * * *         *     
*************************** 
