  *********************
              * *     *
* ******* * *** ***** *
* *   *   *           *
*** * * *** *** *** * *
*   *   * *   * *   * *
*** *** * * ***** * ***
* *   * * *   *   * * *
* * ***** * * * ***** *
*     * *   * *   *   *
* * * * ***** ******* *
* * *   *   * * *   * *
******* * * *** * * * *
*         *   * * *   *
*** ******* *** * * ***
*   *           * *   *
*** * * *** *** ***** *
*   * *   *   *       *
*** * * *** *** *** ***
*   * *   * *     *   *
* ***** * *** ******* *
*   *   * *     *     
********************* 


