*******************************
  *   * *     *           *     *
* * *** ***** ******* *** * *****
* *     *         * *   * *     *
* ***** * ******* * ***** * *****
*   *         *     *       * * *
*** * *********** ***** *** * * *
*     * * *           * *   *   *
* * *** * * ******* *** * *** ***
* * * *     * * *   *   * * *   *
* *** * ***** * * * *** *** *** *
* *     * *   *   *     * * *   *
***** *** *** *** * * * * * *** *
* * *       * *   * * *   * * * *
* * ***** *** *** * *** *** * * *
*   *     *       * * *   *     *
*** *********** *** * *** *** * *
*   *   *   * *   *   *   *   * *
* ***** * *** ***** ***** * * ***
* *   * *       *     * * * *   *
* * * * * * ********* * ******* *
*   *     *               *     *
******* ***** ********* *** * ***
*   *   * * * * * *     *   *   *
*** * *** * *** * *** ********* *
*       * *   *       *     *   *
******* * * ********* *** * *** *
* *       *   *   * * * * *     *
* ******* * *** *** * * * * *** *
*   *         * *         * *   *
* * *** * * *** *** *** *** *** *
* *     * *     *   *   *   *   
******************************* 
