  *******************
    *   *           *
* * *** *** *** *****
* * *     *   *   * *
*** *** *** * *** * *
* *       * * *     *
* * * *** * * *** ***
* * * *     * *     *
* * ***** * ******* *
*       * *   *     *
******* * * ***** * *
*       * *   *   * *
* *** ***** ******* *
* * * * *       *   *
* * *** ******* * * *
*     * *       * * *
* ***** ********* * *
*   * *     *     * *
*** * ***** ***** ***
*               *   
*******************
