  ***********************
    * * * *             *
* *** * * ******* * *** *
*   *     *     * * *   *
* *** * ***** *** *** * *
*   * * * *   *   *   * *
* ***** * * *** *** *** *
*   *     *     *   *   *
*** ***** ******* *******
*   * *     *   *     * *
*** * *** *** *** ***** *
* * *       *   *   *   *
* * *** *** * *** *** * *
*   * * * * * *   *   * *
* *** * * *** * ******* *
*   *   * *     *       *
*** *** * * *** * *** ***
*             * *   * * *
***** * *** *** * * *** *
*     * * *   * * * *   *
***** *** * *** * *** ***
* *     * * *           *
* ***** * *** * *** * * *
*           * *   * * * 
*********************** 


