  *****************************
      *     * *     *         *
*** ***** *** * *********** * *
*               *   * * * * * *
*** ***** ***** * * * * * * * *
*   * * * *   * * *     *   * *
* *** * ***** ***** * *** *****
*       *     *     * *   *   *
******* * * * *** ***** *** ***
*         * *   *   *       * *
* * * ***** ***** * * ******* *
* * *     *       *   *       *
***** * * *** * ********* *** *
*   * * *   * *     *   *   * *
*** * *** * * * * ***** * * * *
*   * *   * * * *         * * *
* ***** * * * * *** ***** * ***
*   * * * * * * *   * * * * * *
* *** ***** ******* * * * *** *
*   * * *   *   * *   * *     *
*** * * * ***** * *** * *******
* *   *     * *   * *         *
* * *** *** * *** * * ******* *
* * * * *   *   * * *     *   *
* * * * * *** *** * *** ***** *
*       *         * * * * * * *
* * *** *** * *** * * *** * * *
* *   *   * * *   *     * *   *
* ***** * ******* * *** * * ***
*   *   * *           *   *   
***************************** 

